+#############################+
|                             |
|                             |
|## ########### ##   #########|
|   |                         |
| | |### |  |           |     |
| |      |  | |###  |   |  |  |
| | #####|  | |      ## |     |
| |           |###  |      |  |
| |##### ###         ##       |
|          ######  ####### ###|
|                             |
|# ### ####      ###   #######|
|                             |
|                             |
|                             |
|                             |
+#############################+